10000 B.C.(2008).XViD-PreVaill.br.srt	Ação
127 Hours (2010).BDRip.Larceny.br.srt	Aventura
12 Rounds.DVDRip.aXXo.br.srt	Crime
15 Minutes(2001).br.srt	Crime
17 Again.720p.REFiNED.br.srt	Comédia
1984 (1956).br.srt	Drama
20000 Leagues Under The Sea (1954).br.srt	Aventura
21 21 The Movie .R5.PUKKA.br.srt	Drama
21 Jump Street (2012).BRRIP.Felony.br.srt	Ação
27 Dresses.DVDRip.FXG.br.srt	Comédia Romântica
28 Days Later....DVDRip.BugZ.br.srt	Terror
28 Weeks Later (2007).DVDRip.aXXo.br.srt	Terror
2 Fast 2 Furious.DVDScr.DVL.br.srt	Ação
3 Idiots.DVDRip.br.srt	Comédia
88 Minutes.DVDRip.PRoDJi.br.srt	Crime
8 Mile.DVDRip.ViTE.br.srt	Drama
9 nine .R5.DEViSE.br.srt	Ação
Abandoned The.DVDRip.aXXo.br.srt	Terror
Absolution.1080p.BlueRay.YIFY.br.srt	Ação
Accepted.DVDRip.aXXo.br.srt	Comédia
Ace Of Hearts.DVDRip.VoMiT.br.srt	Drama
Ace Ventura Jr Pet Detective.DVDRip.JACKVID.br.srt	Comédia
Ace Ventura Pet Detective.DVDRip.BugBunny.br.srt	Comédia
Ace Ventura When Nature Calls.DVDRip.DVDiSO.br.srt	Comédia
A Clockwork Orange.hO@SiLU.br.srt	Drama
Across the Hall.BRRIP.NPW.br.srt	Mistério
Adam.DVDRip.iFN.br.srt	Drama
A Dangerous Man (2010).DVDRip.LUMiX.br.srt	Ação
A Dirty Shame.DVDRip.KJS.br.srt	Comédia
Adventureland.DVDRip.LTT.br.srt	Comédia
Adventures of Tintin The Secret of the Unicorn The (2011).BRRIP.NYDIC.br.srt	Ação
Aeon Flux.DVDRip.DiAMOND.br.srt	Ficção científica
Aferim .720p.BlueRay.mfcorrea.br.srt	Aventura
After Hours.DVDRip.MHQ.br.srt	Comédia
After.life.DVDRip.aXXo.br.srt	Terror
After Sex.DVDRip.iNTiMiD.br.srt	Comédia
After The Sunset.DVDRip.BTSFilms.br.srt	Ação
A Home at the End of the World.DVDRip.DoNE.br.srt	Drama
Air Force One (1987).DVDRip.br.srt	Ação
Aladdin.1080p.EuReKA.br.srt	Ação
Alexander(2004).br.srt	Ação
Alice In Wonderland.DVDRip.PARTiCLE.br.srt	Aventura
Alice In Wonderland.TS.IMAGiNE.br.srt	Aventura
Alien 3.DVDRip.HaLTRoN.br.srt	Terror
Alien Resurrection Alien 4  (1997).BRRIP.GAZ.YIFY.br.srt	Terror
Aliens vs. Predator Requiem(2007).XViD-TeAmQCT.br.srt	Terror
A Life Less Ordinary.DVDRip.br.srt	Comédia
All the President s Men.br.srt	Drama
Almighty Thor (2011).TS.br.srt	Aventura
Alpha Dog.DVDRip.br.srt	Crime
Alvin And The Chipmunks.R5.PUKKA.br.srt	Infantil
Alvin And The Chipmunks The Squeakquel.DVDRip.RUBY.br.srt	Infantil
A Man for All Seasons(1966).br.srt	Drama
Amazing Spider Man The (2012).BRRIP.KiNGDOM.br.srt	Aventura
Amelie Le fabuleux destin d Am lie Poulain  (2001).DVDRip.Mindbreaker.br.srt	Drama
American Beauty (1999).br.srt	Drama
American Gangster.LTT.br.srt	Crime
American Pie 2.DVDRip.NeRoZ.br.srt	Comédia
American Pie 5 The Naked Mile.720p.HDL.br.srt	Comédia
American Pie.DVDRip.HLS.br.srt	Comédia
American Pie Presents Band Camp American Pie 4 Band Camp .DVDRip.NeRoZ.br.srt	Comédia
American Pie Presents Beta House(2007).br.srt	Comédia
American Pie Presents The Book of Love(2009).DVDRip.RUBY.br.srt	Comédia
American Sniper.1080p.BlueRay.RARBG.br.srt	Ação
A Mighty Heart(2007).DVDRip.XviD-DiAMOND.br.srt	Drama
Amistad.720p.CtrlHD.br.srt	Drama
Amnesia.DVDRip.GHOURLS.br.srt	Ação
An American Werewolf In London.KLAXXON.br.srt	Comédia
Anatomy of a Murder (1959).BDRip.br.srt	Crime
Angels And Demons.R5.DEViSE.br.srt	Aventura
Animal Farm.BrRip.MkvCage.br.srt	Mistério
Anna Karenina (2012).1080p.YIFY.br.srt	Drama
Another Cinderella Story(2008).br.srt	Comédia
Antichrist.DVDScr.iLG.br.srt	Terror
Ant Man.1080p.BlueRay.PSA.br.srt	Aventura
Apocalypse Now (1979).1080p.CHD.br.srt	Drama
Apollo 13.720p.ESiR.br.srt	Drama
Armageddon.br.srt	Ficção científica
Artificial Intelligence AI (2001).1080p.br.srt	Ficção científica
As Good As Dead.BRRIP.Rx.br.srt	Crime
Assassination of Jesse James by the Coward Robert Ford The.DVDRip.FXG.br.srt	Crime
Ast rix Et Les Vikings Asterix And The Vikings .DVDRip.CHWD.br.srt	Comédia
Ast rix Ob lix Mission Cl op tre Asterix Obelix Mission Cleopatra (2002).br.srt	Comédia
Atlantis The Lost Empire.DVDRip.DOMiNiON.br.srt	Infantil
Avatar.TS.COASTER.br.srt	Aventura
Avengers Age of Ultron.BrRip.br.srt	Aventura
Avengers The (2012).BRRIP.ETRG.br.srt	Aventura
Aventuras de Robinson Crusoe Las(1954).br.srt	Aventura
A Walk To Remember(2002).br.srt	Drama
Bachelor Party.srt	Comédia
backtothefuture2.srt	Ficção científica
Back to the future (BR-Portuguese by Kurgan).srt	Ficção científica
backtothefutureIII.srt	Ficção científica
Bad Boys(1995).DVDRip.iNTERNAL-TWiST.br.srt	Ação
Bad_Boys_2_port.srt	Ação
Bad Boys II.TS.br.srt	Ação
Bad Teacher (2011).BRRIP.LTRG.br.srt	Comédia
Baixio Das Bestas Bog Of Beasts (2007).DVDRip.XviD-pedr1nho.br.srt	Drama
Bambi.1942.DVDRip.XviD-MiNT.srt	Infantil
Bambi.br.srt	Infantil
Basic Instinct 2.DVDRip.aXXo.br.srt	Drama
Basic Instinct.srt	Drama
Batman Begins.DVDRip.CaGe.br.srt	Aventura
Batman - Mystery of the Batwoman (BR).srt	Aventura
Batman.srt	Aventura
battleroyaleespecialedition-Brazilianportuguese[Xsubt.com][0719948011].srt	Ficção científica
Battleship (2012).TS.YanKeeS.br.srt	Ficção científica
Battlestar Galactica Razor(2007).br.srt	Ficção científica
Battlestar Galactica The Plan.DVDRip.VoMit.br.srt	Ficção científica
Beach The.DVDRip.NikonXp.br.srt	Drama
Beasts of No Nation.720p.BlueRay.[YTS.AG].br.srt	Drama
Beauty.and.the.Beast.DVDRip.(BR).srt	Infantil
Beauty And The Beast.DVDRip.Stealthmaster.br.srt	Infantil
Be.Cool.FS.DVDRip.DivX.OTR.[shareprovider.com].srt	Drama
Bee Movie.DVDRip.DiAMOND.br.srt	Infantil
Beetlejuice-Divx-DVDRIP.srt	Comédia
Before Sunrise.srt	Comédia Romântica
Before.Sunset.Limited.DVDRiP.XViD-DEiTY.srt	Comédia Romântica
Before the Devil Knows You re Dead.DVDRip.leetay.br.srt	Crime
Beira do Caminho (2012).DVDRip.3LT0N.br.srt	Drama
Ben Hur (1959).HDRIP.CaLLiOpeD.br.srt	Drama
Beowulf(2007).br.srt	Aventura
Big Fish.xvid.sub	Aventura
Big Lebowski The(1998).br.srt	Comédia
Black Night.sub	Ficção científica
Black Swan (2010).DVDScr.ViSiON.br.srt	Drama
Black Water.DVDRip.BeStDivX.br.srt	Terror
blade2 cd1 648 MB.sub	Aventura
BLADE_2.divx5@775.srt	Aventura
Blade Runner.1080p.SZ.br.srt	Ficção científica
Blade runner (BR portuguese by Kurgan).srt	Ficção científica
Blade.Trinity.WS.DVDSCR.XviD-MoF.sub	Aventura
Blair Witch Project The.DVDRip.Occor.br.srt	Terror
Blonde and Blonder(2007).DVDRip.XviD-BETAMAX.br.srt	Comédia
Blood Diamond.720p.ESiR.br.srt	Drama
Blue Lagoon The.DVDRip.greenbud1969.br.srt	Drama
Boat That Rocked The.720p.iNFAMOUS.br.srt	Comédia
Bodyguard 2 The.DVDRip.3Mhome.br.srt	Comédia Romântica
Bodyguard The (1992).DVDRip.NoTiMPoRTaNT.br.srt	Comédia Romântica
Bolt.DVDScr.KingBen.br.srt	Infantil
Bonnie and Clyde.br.srt	Crime
Book Of Eli The.DVDScr.PrisM - MC68.br.srt	Drama
Bourne Identity The.720p.ESiR.br.srt	Ação
Bourne Supremacy The(2004).br.srt	Ação
Bourne Ultimatum The.DVDRip.FxM.br.srt	Ação
Boy In The Striped Pyjamas The.DVDRip.BLiTZKRiEG.br.srt	Drama
Braveheart.720p.ESiR.br.srt	Drama
Braveheart.srt	Drama
Breakfast at.Tiffanys.(1961).SOUTHSiDE.srt	Comédia
Breakin.All.the.Rules.2004.DVDRip.XviD-PROMiSE.srt	Comédia Romântica
Bridge Of Spies.CPG.br.srt	Drama
Bridget Jones The Edge Of Reason TUS kvcd.sub	Comédia Romântica
Br no.TS.SecretMyth Kingdom-Release.br.srt	Comédia
Br no.TS.SecretMyth Kingdom-Release.br.srt (2)	Comédia
Bruce.Almighty.XviD.MTT.srt	Comédia
Burn After Reading.R5.PUKKA.br.srt	Comédia
Burning Plain The.DVDRip.FxM.br.srt	Crime
Butterfly Effect 2 The.DVDRip.[BugBunny].br.srt	Drama
Butterfly Effect The.DVDRip.Zeus_Dias.br.srt	Drama
Caller The.DVDRip.ARiGOLD.br.srt	Mistério
Call Of The Wild.DVDRip.VoMiT.br.srt	Aventura
Capitalism A Love Story.DVDRip.SAPHiRE.br.srt	Documentário
Capote.DVDRip.iMBT.br.srt	Drama
Captain America The First Avenger (2011).TS.WBZ.br.srt	Aventura
Casino.HDDVDRip.hV.br.srt	Crime
Casino Job The.DVDRip.VH-PROD.br.srt	Crime
Casino Royale.BDRip.Z0N3.br.srt	Ação
Catch Me If You Can.DVDRip.BraveDOG.br.srt	Drama
Catwoman.DVDRip.ALLiANCE.br.srt	Aventura
Chicken Little.br.srt	Infantil
Chico Xavier.DVDRip.Lis.br.srt	Drama
Chinatown (1974).BRRIP.vice.br.srt	Drama
Chronicles Of Narnia Prince Caspian The.TS.STG.br.srt	Infantil
Chronicles Of Narnia Prince Caspian The.TS.STG.br.srt (2)	Infantil
Chronicles Of Narnia The Voyage Of The Dawn Treader The (2010).BRRIP.Deceit.YIFY.br.srt	Infantil
Cinderella Story A.1080p.DETAiLS.br.srt	Infantil
Click.720p.JUPiT.br.srt	Comédia
Closer(2004).DVDRip.Closer[2004]dvdrip[xvid]eng.ac3[ws].br.srt	Drama
Cloudy With A Chance Of Meatballs.DVDRip.ViSiON.br.srt	Infantil
Color Of Money The(1986).br.srt	Drama
Con Air.DVDRip.FRAGMENT.br.srt	Ação
Conquest of the Planet of the Apes (1972).1080p.CLASSiC.br.srt	Ficção científica
Constantine.720p.CtrlHD.br.srt	Aventura
Countess The(2009).DVDRip.TXF.br.srt	Drama
Count of Monte Cristo The.DVDRip.br.srt	Aventura
Cowboys and Aliens (2011).720p.br.srt	Ficção científica
Crash.DVDRip.br.srt	Drama
Crocodile Dundee In Los Angeles(2001).br.srt	Comédia
Crying Game The(1992).br.srt	Drama
Curious Case Of Benjamin Button The.DVDScr.DEViSE.br.srt	Drama
Daddy Day Camp(2007).DVDRip.XviD-VoMiT.br.srt	Comédia
Dances with Wolves(1990).br.srt	Drama
Danton(1983).br.srt	Drama
Dark Knight Rises The (2012).TS.26K.br.srt	Aventura
Da Vinci Code The(2006).DVDRip.aXXo.br.srt	Mistério
Dawn Of The Planet Of The Apes (2014).br.srt	Ficção científica
Day Of The Dead.1080p.hV.br.srt	Terror
Deep Impact.DVDRip.[dunga].br.srt	Ação
Devil s Advocate The.720p.ESiR.br.srt	Drama
Diarios de motocicleta The Motorcycle Diaries .DVDRip.RIZZ.br.srt	Aventura
Dick Tracy (1990).br.srt	Crime
Dictator The (2012).TS.26k.br.srt	Comédia
Die Hard(1988).br.srt	Ação
Django Unchained (2012).720p.SPARKS.br.srt	Drama
Dodgeball A True Underdog Story(2004).br.srt	Comédia
Doom.DVDRip.MissRipZ.br.srt	Aventura
Driving Miss Daisy.DVDRip.br.srt	Drama
Duchess The(2008).DVDRip.DiAMOND.br.srt	Drama
Elektra (2005).br.srt	Aventura
El Mariachi(1992).br.srt	Ação
Enter The Void (2009).DVDRip.2010.br.srt	Drama
Epic Movie(2007).DVDScr.XviD-NEPTUNE.br.srt	Comédia
Erin Brockovich.DVDRip.LOVE.br.srt	Drama
Escape from the Planet of the Apes (1971).1080p.BOKUTOX.YIFY.br.srt	Ficção científica
Escapist The.KLAXXON.br.srt	Crime
Eternal Sunshine of the Spotless Mind.720p.CtrlHD.br.srt	Drama
Everest.BrRip.EVO.br.srt	Aventura
Evita.br.srt	Drama
Ex Machina.Bluray.2015.br.srt	Ficção científica
Expendables The.BRRIP.ViSiON.br.srt	Ação
Eyes Wide Shut (1999).BRRIP.YIFY.br.srt	Drama
Fair Game (2010).BDRip.CM8.br.srt	Drama
Fall The.1080p.CiNEFiLE.br.srt	Crime
Family Guy Presents Something Something Something Dark Side.BRRIP.SANTi.br.srt	Comédia
Fantastic Four.DVDRip.br.srt	Aventura
Fantastic Four Rise of the Silver Surfer.DVDRip.aXXo.br.srt	Aventura
Far Cry.DVDRip.BeStDivX.br.srt	Ficção científica
Fargo.DVDRip.FxM.br.srt	Crime
Fast and the Furious Tokyo Drift The.DVDRip.~SaaS~.br.srt	Aventura
Fast Five Fast Furious 5 The Rio Heist  (2011).BDRip.SCR0N.br.srt	Aventura
Fast Food Nation(2006).br.srt	Documentário
Fast Furious.TS.STG.br.srt	Aventura
Ferris Bueller s Day Off.DVDRip.FWBrasil.br.srt	Comédia
Fifty Shades Of Grey.720p.BlueRay.YIFY.br.srt	Drama
Fight Club.DVDRip.PiLFER.br.srt	Drama
Final Countdown The.720p.ESiR.br.srt	Ficção científica
Final Fantasy VII Advent Children(2005).br.srt	Aventura
First Blood.1080p.BlueRay.RARBG.br.srt	Ação
Flashdance.720p.PiGO.br.srt	Musical
Footloose (2011).BRRIP.Z3RO.br.srt	Musical
Forrest Gump(1994).DVDRip.Rets.br.srt	Drama
Freddy s Dead The Final Nightmare (1991).BRRIP.BOKUTOX.YIFY.br.srt	Terror
Freddy vs. Jason (2003).BRRIP.BOKUTOX.YIFY.br.srt	Terror
Free Willy.1080p.BlueRay.YIFY.br.srt	Drama
Friday the 13th.DVDRip.FxM.br.srt	Terror
Friends With Benefits (2011).DVDRip.Jaybob.br.srt	Comédia Romântica
Frozen.720p.BlueRay.YIFY.br.srt	Infantil
Gallactica_port.srt	Ficção científica
Game Plan The(2007).DVDRip.The Game Plan[2007]DvDrip[Eng]-FXG.br.srt	Comédia
Gamer.R5.PrisM.br.srt	Ficção científica
Gangs of New York (2002).720p.AVCHD.br.srt	Crime
Ghost Rider.DVDRip.aXXo.br.srt	Aventura
Ghost Writer The.BRRIP.ViSiON.br.srt	Mistério
G.I. Joe Retaliation (2013).TS.UnKnOwN.br.srt	Ação
Girl Next Door The.DVDRip.FxM.br.srt	Comédia
Gladiator.DVDRip.aXXo.br.srt	Ação
Godfather Part II The(1974).br.srt	Crime
Godfather The.br.srt	Crime
Grease (1978).BRRIP.YIFY.br.srt	Musical
Great Expectations (2012).1080p.br.srt	Drama
Green Lantern First Flight.720p.br.srt	Aventura
Green Mile The(1999).br.srt	Drama
Guardians Of The Galaxy.1080p.BlueRay.SPARKS.br.srt	Aventura
Guardian The.DVDRip.aXXo.br.srt	Ação
Hack (2007).DVDRip.XviD-VoMiT.br.srt	Mistério
Hacker s Game.HDRip.2015.br.srt	Drama
Halloween (2007).br.srt	Terror
Halloween H20 20 Years Later.Hhah.br.srt	Terror
Halloween II.TS.DWS.br.srt	Terror
Halo Legends.720p.MELiTE.br.srt	Ficção científica
Hancock.PLUBE.br.srt	Aventura
Hangover Part 2 The (2011).TS.EP1C.br.srt	Comédia
Hangover The.DVDScr.ANALSHiT.br.srt	Comédia
Hannah Montana The Movie.DVDRip.FXG.br.srt	Infantil
Hannibal (2001).720p.HANGOVER.br.srt	Crime
Hannibal Rising(2007).br.srt	Crime
Happy Feet(2006).DVDRip.XviD-LRC.br.srt	Infantil
Happy Feet Two (2011).DVDRip.COCAIN.br.srt	Infantil
Harry Potter and Deathly Hallows Part 1 (2010).BRRIP.ViSiON.br.srt	Aventura
Harry Potter And Deathly Hallows Part 2 (2011).TS.IMAGiNE.br.srt	Aventura
Harry Potter and the Chamber of Secrets.br.srt	Aventura
Harry Potter And The Goblet Of Fire(2005).br.srt	Aventura
Harry Potter And The Half blood Prince.TS.ViSiON.br.srt	Aventura
Harry Potter and the Order of the Phoenix (2007).DVDRip.FLAiTE.br.srt	Aventura
Harry Potter and the Prisoner of Azkaban.DVDRip.aXXo.br.srt	Aventura
Harry Potter and the Sorcerer s Stone.br.srt	Aventura
Hellboy(2004).DVDRip.XviD-iRB.br.srt	Aventura
Hellboy II The Golden Army.DVDRip.3LT0N.br.srt	Aventura
High Fidelity.DVDRip.WaRLoRD.br.srt	Drama
High School Musical 3 Senior Year.TS.COALiTiON.br.srt	Musical
Hitman(2007).DVDRip.Hitman[2007]DvDrip[Eng]-MvUp.br.srt	Ação
Home Alone (1990).720p.anoXmous.br.srt	Comédia
Home Alone 2 Lost in New York (1992).720p.anoXmous.br.srt	Comédia
Hook.HDRIP.PRoDJi.br.srt	Aventura
Hooligans.DVDRip.aXXo.br.srt	Crime
Hotel Rwanda.720p.PPQ.br.srt	Drama
Hotel Transylvania 2.BrRip.ETRG.br.srt	Infantil
Hours The.DVDRip.DEiTY.br.srt	Drama
Hulk.1080p.ESiR.br.srt	Aventura
Hurricane The (1999).DVDRip.NiLE.br.srt	Drama
Hush.1080p.hV.br.srt	Drama
I Am Legend.DVDScr.THS.br.srt	Ficção científica
Ice Age(2002).br.srt	Infantil
Ice Age 4 Continental Drift (2012).1080p.YIFY.br.srt	Infantil
Ice Age Dawn of the Dinosaurs.R5.SPooL.br.srt	Infantil
Ice Age The Meltdown.TC.ASTEROiDS.br.srt	Infantil
I Hope They Serve Beer in Hell.DVDRip.AMIABLE.br.srt	Comédia
Illusionist The(2006).DVDRip.XviD-DiAMOND.br.srt	Drama
Imposter The (2008).DVDRip.3LT0N.br.srt	Documentário
Inception.TS.IMAGiNE.br.srt	Ação
Incredible Hulk The.NEPTUNE.br.srt	Aventura
Incredibles The.DVDRip.br.srt	Aventura
Indecent Proposal.DVDRip.br.srt	Drama
Independence Day (1996).br.srt	Ficção científica
Indiana Jones And The Kingdom Of The Crystal Skull.720p.Chakra.br.srt	Aventura
Indiana Jones and the Last Crusade.DVDRip.br.srt	Aventura
Indiana Jones and the Temple of Doom.br.srt	Aventura
Infidel The (2010).DVDRip.ALLiANCE.br.srt	Comédia
Inglourious Basterds.DVDRip.Noir.br.srt	Drama
In the Name of the Father (1993).720p.ThD.br.srt	Drama
Intouchables Untouchable  (2011).1080p.LOST.br.srt	Drama
I Robot.DVDRip.BugZ.br.srt	Ficção científica
Iron Man 2.TS.T0XiC.br.srt	Aventura
Iron Man.TS.KingBen.br.srt	Aventura
Island of Dr. Moreau The.br.srt	Ficção científica
Italian Job The(1969).DVDRip.DivX-MDX.br.srt	Crime
Jackass The Lost Tapes.DVDRip.ViSiON.br.srt	Comédia
James Bond 007 Quantum Of Solace.DVDRip.DUQA.br.srt	Ação
Jaws (1975).BRRIP.YIFY.br.srt	Drama
Jay And Silent Bob Strike Back.720p.SEPTiC.br.srt	Comédia
Jennifer s Body.R5.IMAGINE.br.srt	Comédia
JFK.720p.SiNNERS.br.srt	Drama
Journey To The Center Of The Earth.DVDRip.FXG.br.srt	Aventura
Juno.DVDScr.br.srt	Comédia
Jurassic Park.DVDRip.UnSeeN.br.srt	Ficção científica
Jurassic World.HDRip.RARBG.br.srt	Ficção científica
Just Friends.DVDRip.aXXo.br.srt	Comédia
Just Like Heaven.DVDRip.DreamTeamShare.br.srt	Comédia Romântica
K 19 The Widowmaker (2002).BRRIP.YIFY.br.srt	Drama
Karate Kid The.720p.METiS.br.srt	Aventura
Kick ass.DVDRip.FXG.br.srt	Comédia
Kill Bill Vol. 1.DVDRip.DiCE.br.srt	Ação
Kill Bill Vol. 2(2004).br.srt	Ação
Killer Movie.DVDRip.FXG.br.srt	Comédia
Killing Them Softly (2012).BRRIP.YIFY.br.srt	Crime
King Kong.BrRip.MkvCage.br.srt	Aventura
K Pax (2001).Gabe.br.srt	Drama
Kung Fu Panda 2 (2011).TS.EP1C.br.srt	Infantil
Kung Fu Panda.TS.mVs.br.srt	Infantil
L.A. Confidential.1080p.BlueRay.ETRG.br.srt	Crime
Lara Croft Tomb Raider.DVDRip.VALiOMEDiA.br.sub	Aventura
Last King Of Scotland The.DVDRip.aXXo.br.srt	Drama
Last Night (2010).BDRip.iLG.br.srt	Drama
Last Samurai The.DVDRip.FXG.br.srt	Ação
Lawrence Of Arabia.BrRip.MkvCage.br.srt	Aventura
Legend of the Lone Ranger The (1981).DVDRip.VH-PROD.br.srt	Aventura
Lesbian Vampire Killers.DVDRip.aXXo.br.srt	Comédia
Lethal Weapon(1987).br.srt	Ação
Lethal Weapon 2(1989).br.srt	Ação
Lethal Weapon 4(1998).br.srt	Ação
Life Of Brian(1979).br.srt	Comédia
Lilo And Stitch.br.srt	Infantil
Lion King The.DVDRip.Stealthmaster.br.SRT	Infantil
Little Mermaid Ariel s Beginning The.DVDRip.aXXo.br.srt	Infantil
Little Mermaid The.br.srt	Infantil
Little Miss Sunshine (2006).DVDRip.DiAMOND.br.srt	Comédia
Lock Stock and Two Smoking Barrels(1998).br.srt	Ação
Lolita(1962).br.srt	Drama
Lord of the Rings The Fellowship of the Ring The.DVDRip.SecretMyth.br.srt	Aventura
Lord of the Rings The Return of the King The.720p.THOR.br.srt	Aventura
Lord of the Rings The Two Towers The.DVDRip.SecretMyth.br.srt	Aventura
Lost Boys The (1987).DVDRip.br.srt	Comédia
Love And Other Drugs (2010).BRRIP.Noir.br.srt	Comédia Romântica
Loverboy (2011).DVDRip.LAP.br.srt	Comédia
Madagascar.720p.SiNNERS.br.srt	Infantil
Madagascar Escape 2 Africa.TC.COALiTiON.br.srt	Infantil
Mafia (2011).BDRip.NOSCREENS.br.srt	Ação
Magnolia.DVDRip.br.srt	Drama
Malcolm X (1992).BRRIP.BOKUTOX.YIFY.br.srt	Drama
Man of the Year(2006).DVDRip.Year[2006]DvDrip[Eng]-aXXo.br.srt	Comédia
Man With The Golden Gun The.DVDRip.br.srt	Ação
Man With The Iron Fists The (2012).1080p.LTRG.br.srt	Ação
Marche de l empereur La March of the Penguins  (2005).DVDRip.br.srt	Documentário
Marco Polo One Hundred Eyes.AFG.br.srt	Ação
Marley Me.TS.Smokie1313.br.srt	Comédia Romântica
Master Of Disguise The(2002).DVDRip.XViD-DcN.br.srt	Comédia
Mata Hari(1931).DVDRip.XviD-FRAGMENT.br.srt	Drama
Match Point.DVDRip.aXXo.br.srt	Drama
Matrix Reloaded The (2003).br.srt	Ficção científica
Matrix Revolutions The.br.srt	Ficção científica
Matrix The.DVDRip.KEKO.br.srt	Ficção científica
Maverick.720p.hV.br.srt	Ação
Max Payne.720p.SEPTiC.br.srt	Ação
Meet The Robinsons.DVDRip.aXXo.br.srt	Infantil
Megamind (2010).1080p.BDRip.br.srt	Infantil
Midnight in Paris (2011).1080p.MaxHD.br.srt	Drama
Minority Report (2002).1080p.YIFY.br.srt	Ficção científica
Mis rables Les (2013).1080p.br.srt	Drama
Mission Impossible.DVDRip.keltz.br.srt	Aventura
Mission Impossible Ghost Protocol (2011).720p.HDChina.br.srt	Aventura
Mission Impossible II(2000).br.srt	Aventura
Mission Impossible III(2006).DVDRip.Mission-Impossible.3[2006]DvDrip[Eng]-aXXo.br.srt	Aventura
Mission Impossible Rogue Nation.WEBRip.EVE.br.srt	Aventura
Moneyball (2011).BRRIP.NYDIC.br.srt	Drama
Monster House.TC.PUKKA.br.srt	Infantil
Monsters Vs Aliens.DVDRip.JUMANJi.br.srt	Infantil
Moonwalker.DVDRip.DplaneT.br.srt	Musical
Mr. Deeds(2002).br.srt	Comédia
Mr. Mrs. Smith.DVDRip.aXXo.br.srt	Ação
Mulholland Drive (2001).1080p.TFiN.br.srt	Mistério
Mummy Returns The(2001).DVDRip.aXXo.br.srt	Aventura
My Girl.DVDRip.greenbud1969.br.srt	Comédia Romântica
Night at the Museum.DVDRip.aXXo.br.srt	Comédia
Nine 1 2 Weeks (1986).720p.HD4U.br.srt	Drama
Norbit(2007).br.srt	Comédia
Notting Hill.DVDRip.woodster.br.srt	Comédia Romântica
Obsessed.720p.iNFAMOUS.br.srt	Drama
Ocean s Eleven.HDDVDRip.SiNNERS.br.srt	Aventura
Ocean s Thirteen.DVDRip.aXXo.br.srt	Aventura
Ocean s Twelve(2004).TS.TS-DreamCD.br.srt	Aventura
One Flew Over the Cuckoo s Nest (1975).1080p.LoNeWoLf.br.srt	Drama
Open Season 2.DVDRip.aXXo.br.srt	Infantil
Open Season.DVDRip.DoNE.br.srt	Infantil
Other Guys The.R5.LAP.br.srt	Comédia
Others The (2001).DVDRip.x0DuS.br.srt	Terror
Paranormal Activity 3 (2011).BRRIP.AbSurdiTy.br.srt	Terror
Paranormal Activity.DVDScr.ExtraSceneRG.br.srt	Terror
Paranormal Activity The Ghost Dimension.1080p.BlueRay.RARBG.br.srt	Terror
Patriot The.BDRip.TJ.br.srt	Ação
Peanuts Movie The.DVDScr.TiTAN.br.srt	Infantil
Pearl Harbor.DVDRip.BugZ.br.srt	Drama
Perfume The Story of a Murderer(2006).br.srt	Crime
Piano The (1993).1080p.AVCHD.br.srt	Drama
Pink Floyd The Wall.DVDRip.br.srt	Musical
Pirates of the Caribbean At World s End (2007).1080p.BlueRay.RARBG.br.srt	Aventura
Pirates of the Caribbean Dead Man s Chest.1080p.BlueRay.RARBG.br.srt	Aventura
Pirates of the Caribbean On Stranger Tides (2011).DVDRip.MAXSPEED.br.srt	Aventura
Pirates of the Caribbean The Curse of the Black Pearl.hV.br.srt	Aventura
Planet of the Apes (1968).1080p.BDRip.br.srt	Ficção científica
Planet of the Apes The (2001).720p.YIFY.br.srt	Ficção científica
Platoon (1986).720p.br.srt	Ação
Poltergeist(1982).br.srt	Terror
Poseidon (2006).1080p.BDRip.br.srt	Ação
Predator 2.720p.PoTuS.br.srt	Terror
Predator.DVDRip.CNT.br.srt	Terror
Premonition(2007).DVDRip.Premonition[2007]DvDrip[Eng]-aXXo.br.srt	Terror
Prestige The.DVDRip.aXXo.br.srt	Ficção científica
Pretty Woman.720p.AVS720.br.srt	Comédia Romântica
Priest (2011).DVDRip.TWiZTED.br.srt	Ação
P.S. I Love You.DVDRip.FXG.br.srt	Comédia Romântica
Public Enemies.BRRIP.ViSiON.br.srt	Crime
Pulp Fiction (1994).DVDRip.P4DGE.br.srt	Ação
Pursuit Of Happyness The.1080p.iLL.br.srt	Drama
Puss in Boots (2011).BRRIP.3LT0N.br.srt	Infantil
Raiders Of The Lost Ark(1981).br.srt	Aventura
Rambo(2008).br.srt	Ação
Ratatouille.DVDRip.EVO.br.srt	Infantil
Reader The.DVDScr.Noir.br.srt	Drama
Rear Window(1954).br.srt	Mistério
Rebound The.R5.PrisM.br.srt	Comédia Romântica
Red (2010).DVDScr.br.srt	Ação
Remember Me.TS.PrisM.br.srt	Drama
Requiem for a Dream.DVDRip.AB.br.srt	Drama
Reservoir Dogs (1992).br.srt	Crime
Resident Evil Afterlife (2010).720p.AVS720.br.srt	Ficção científica
Resident Evil Apocalypse.DVDRip.KJS.br.srt	Ficção científica
Resident Evil.DVDRip.Zombiebr.br.srt	Ficção científica
Resident Evil Extinction.BRRIP.PRoDJi.br.srt	Ficção científica
Revenant The.DVDScr.NoGRP.br.srt	Drama
Revolver.DVDScr.LEGACY.br.srt	Crime
Righteous Kill.R5.PUKKA.br.srt	Crime
Rise of the Planet of the Apes (2011).TS.IMAGiNE.br.srt	Ficção científica
Road The.DVDScr.ToXiC.br.srt	Aventura
Robin Hood (2010).BRRIP.YIFY.br.srt	Ação
RocknRolla.DVDRip.aXXo.br.srt	Crime
Rocky.DVDRip.aXXo.br.srt	Aventura
Rocky II.DVDRip.Rets.br.srt	Aventura
Rocky III.DVDRip.Rets.br.srt	Aventura
Rocky IV.DVDRip.Rets.br.srt	Aventura
Rocky V.DVDRip.Rets.br.srt	Aventura
Room.DVDScr.EVO.br.srt	Drama
Rosemary s Baby(1968).br.srt	Terror
Rush Hour 3.DVDRip.NeDiVx.br.srt	Comédia
Saturday Night Fever.DVDRip.br.srt	Musical
Saving Private Ryan.720p.ESiR.br.srt	Drama
Saw.DVDRip.NikonXP.br.srt	Terror
Scarface.br.srt	Crime
Schindler s List(1993).br.srt	Drama
Se7en Seven  (1995).br.srt	Crime
Sex And The City.DVDRip.aXXo.br.srt	Comédia Romântica
Sex Drive Sexdrive (2008).DVDRip.FXG.br.srt	Comédia
Sherlock Holmes A Game of Shadows (2011).TS.BBnRG.br.srt	Aventura
Sherlock Holmes.TS.REPACK.-D3MONZ.br.srt	Aventura
Shooter.DVDRip.aXXo.br.srt	Ação
Shrek 2 (2004).1080p.EbP.br.srt	Infantil
Shrek the Third.DVDRip.FLAiTE.br.srt	Infantil
Shrek.TLF.br.srt	Infantil
Silence of the Lambs The(1991).br.srt	Crime
Silent Hill.1080p.ESiR.br.srt	Terror
Simpsons Movie The.DVDRip.X264.br.srt	Comédia
Sin City.BDRip.Z0N3.br.srt	Crime
Slumdog Millionaire.DVDRip.EVO.br.srt	Drama
Snatch.DVDRip.DCA.br.srt	Ação
Sorcerer s Apprentice The.TS.KiNGDOM.br.srt	Ação
Sound of Music The(1965).br.srt	Musical
Source Code (2011).DVDRip.MAXSPEED.br.srt	Ficção científica
South Park Bigger Longer Uncut.br.sub	Comédia
Speed Racer.DVDRip.FLAWL3SS.br.srt	Aventura
Spider Man 2 (2004).BRRIP.SecretMyth.(Kingdom-Release).br.srt	Aventura
Spider Man 3.DVDRip.MoLoTOV.br.srt	Aventura
Spirit The.DVDRip.DiAMOND.br.srt	Ação
Spread.DVDRip.ARROW.br.srt	Comédia Romântica
Spy.BrRip.br.srt	Comédia
Stalker(1979).br.srt	Ficção científica
Star Trek.DVDRip.FxM.br.srt	Ficção científica
Star Wars.720p.hV.br.srt	Ficção científica
Star Wars Episode II Attack of the Clones.br.srt	Ficção científica
Star Wars Episode I The Phantom Menace.br.srt	Ficção científica
Star Wars Episode VI Return of the Jedi.br.srt	Ficção científica
Star Wars Episode V The Empire Strikes Back.br.sub	Ficção científica
State Of Play.DVDRip.ZEKTORM.br.srt	Crime
Step Up 2 The Streets(2008).Bluray.x264-HDxT.br.srt	Musical
Step Up.DVDRip.aXXo.br.srt	Musical
Stranger Than Fiction.WAF.br.srt	Comédia
Street Kings.DVDScr.KingBen.br.srt	Crime
Sukiyaki Western Django.DVDRip.CODE.br.srt	Ação
Superbad.TS.mVs.br.srt	Comédia
Superhero Movie(2008).DVDRip.1] DragonRipper.br.srt	Comédia
Superman Returns(2006).DVDRip.Superman.Returns[2006]DvDrip[Eng]-aXXo.br.srt	Aventura
Surrogates.1080p.WiKi.br.srt	Ficção científica
Sweeney Todd The Demon Barber of Fleet Street (2007).DVDScr.PUKKA.br.srt	Terror
Switch The.R5.Noir.br.srt	Comédia Romântica
Take Me Home Tonight (2011).720p.MHD.br.srt	Comédia Romântica
Tango Cash.720p.Funner.br.srt	Ação
Tarzan the Ape Man.DVDRip.br.srt	Aventura
Taxi Driver.HDRIP.BDK.br.srt	Drama
Ted (2012).TS.br.srt	Comédia
Teeth(2007).DVDRip.Teeth[2007]DvDrip[Eng]-aXXo.br.srt	Terror
Tekken.DVDRip.Noir.br.srt	Ação
Tenacious D in The Pick of Destiny (2006).DVDRip.DiAMOND.br.srt	Musical
Terminal The.br.srt	Drama
Terminator 2 Judgment Day (1991).720p.WiKi.br.srt	Ficção científica
Terminator Salvation.P2P.br.srt	Ficção científica
Terminator The (1984).720p.3Li.br.srt	Ficção científica
Thank You For Smoking (2005).DVDRip.aXXo.br.srt	Drama
The Day The Earth Stood Still.TS.OPTiC.br.srt	Ficção científica
The Hobbit An Unexpected Journey (2012).1080p.SPARKS.br.srt	Aventura
There Will Be Blood(2008).br.srt	Drama
The Twilight Saga Breaking Dawn Part 2 (2012).TS.LiFT.br.srt	Aventura
Thing The (1982).br.srt	Ficção científica
Thing The (1982).br.srt (2)	Ficção científica
Three Musketeers The (2011).DVDRip.MAXSPEED.br.srt	Aventura
Time Traveler s Wife The.720p.METiS.br.srt	Drama
Titanic.720p.NhaNc3.br.srt	Drama
TMNT.TS.PUKKA.br.srt	Infantil
Top Gun.DVDRip.NuMy.br.srt	Ação
Total Recall (2012).DVDScr.br.srt	Ação
Tournament The.BRRIP.br.srt	Ação
Tower Heist (2011).BRRIP.LEGi0N.br.srt	Comédia
Town The (2010).1080p.Theatrical.br.srt	Crime
Toy Story 2.720p.CtrlHD.br.srt	Infantil
Toy Story 3.DVDRip.Jaybob.br.srt	Infantil
Toy Story.720p.CtrlHD.br.srt	Infantil
Training Day.1080p.SZ.br.srt	Crime
Trainspotting.DVDRip.SONiC.br.srt	Ação
Traitor.DVDRip.ARROW.br.srt	Crime
Transformers.720p.NhaNc3.br.srt	Aventura
Transformers Dark of the Moon (2011).TS.FLAWL3SS.br.srt	Aventura
Transformers Revenge of the Fallen.TS.XDurus.br.srt	Aventura
Transformers The Movie The.DVDRip.aXXo.br.srt	Aventura
Transporter 2.DVDRip.NeRoZ.br.srt	Ação
Transporter 3.TS.iLG.br.srt	Ação
Transporter The(2002).br.srt	Ação
Triangle.BDRip.FRAGMENT.br.srt	Mistério
TRON Legacy (2010).1080p.BDRip.br.srt	Ficção científica
Tropa De Elite The Elite Squad (2007).XviD-ARiSCO.br.srt	Crime
Twelve Angry Men.br.srt	Drama
Twelve Monkeys (1995).br.srt	Ficção científica
Twilight Saga 4 Breaking Dawn Part 1 The (2011).BRRIP.SOuVLaAKI.br.srt	Aventura
Twilight Saga Eclipse The.DVDScr.CRYS.br.srt	Aventura
Twilight Saga New Moon The.POISON.br.srt	Aventura
Twilight.TS.Wolfy.br.srt	Aventura
Ugly Truth The.DVDScr.CAMELOT.br.srt	Comédia Romântica
Ultimate Gift The.DVDRip.FxM.br.srt	Drama
Unborn The.br.srt	Terror
Underworld Awakening (2012).1080p.YIFY.br.srt	Ação
Underworld.DVDRip.Zeus Dias.br.srt	Ação
Underworld Evolution.DVDRip.aXXo.br.srt	Ação
Underworld Rise of the Lycans.DVDScr.Neptune.br.srt	Ação
Unfaithful (2002).BRRIP.YIFY.br.srt	Drama
Uninvited The.DVDRip.FXG.br.srt	Terror
Unknown (2011).1080p.BDRip.br.srt	Mistério
Untraceable.DVDScr.nDn.br.srt	Crime
Up.DVDScr.ROAR.br.srt	Infantil
Up In The Air.DVDScr.SecretMyth.(Kingdom-Release).br.srt	Comédia Romântica
Upside Down (2012).1080p.CHD.br.srt	Drama
Usual Suspects The.BDRip.hO@SiLU.br.srt	Crime
Valkyrie.TS.Valkyrie ( CAM ).br.srt	Drama
Van Helsing The London Assignment (2004).DVDRip.VH-PROD.br.srt	Aventura
Vanilla Sky (2001).br.srt	Drama
Vantage Point(2008).DVDRip.[Eng]-DUQA.br.srt	Crime
Vertical Limit(2000).br.srt	Ação
Vertigo.720p.pTT.br.srt	Mistério
V for Vendetta.DVDRip.FLAWL3SS.br.srt	Aventura
Vicky Cristina Barcelona.720p.SEPTiC.br.srt	Drama
Virgin Territory(2007).DVDRip.Virgin.Territory[2007] DvDrip[Eng]-aXXo.br.srt	Comédia
Vita bella La Life Is Beautiful  (1997).br.srt	Drama
Volver.720p.ortamci.br.srt	Comédia
Walk The.HDRip.EVO.br.srt	Aventura
Walk The Line.720p.ESiR.br.srt	Drama
WALL E.DVDRip.aXXo.br.srt	Infantil
Wall Street Money Never Sleeps.R5.LOADiNG.br.srt	Drama
Wanted.TC.mVs.br.srt	Ação
War.DVDRip.iMBT.br.srt	Ação
War Horse (2011).DVDScr.CM8.br.srt	Drama
Warm Bodies (2013).TS.DUQA.br.srt	Comédia
Warrior (2011).DVDRip.ViP3R.br.srt	Drama
Watchmen.TS.STG.br.srt	Aventura
Waterworld(1995).br.srt	Aventura
We Own the Night.720p.ESiR.br.srt	Crime
We Were Soldiers.720p.REVEiLLE.br.srt	Ação
What A Girl Wants.br.srt	Comédia Romântica
What Happens In Vegas...(2008).DVDRip.Vegas[2008]DvDrip[Eng]-D_Mania.br.srt	Comédia Romântica
What Women Want (2000).720p.DON.br.srt	Comédia
Where The Wild Things Are.DVDRip.ViSiON.br.srt	Aventura
Whip It.DVDRip.FXG.br.srt	Drama
Wild Hogs(2007).TS.XViD-20th.br.srt	Aventura
Wizard of Oz The.720p.SiNNERS.br.srt	Aventura
Wolfman The.TS.MOViERUSH.br.srt	Terror
Woman In Black The (2012).br.srt	Terror
World Is Not Enough The (1999).1080p.BDRip.br.srt	Ação
Wreck It Ralph (2012).BRRIP.br.srt	Infantil
Wrestler The.DVDScr.Noir.br.srt	Drama
X Files I Want to Believe The.DVDRip.DUQA.br.srt	Ficção científica
X men Origins Wolverine.DVDRip.JUMANJi.br.srt	Aventura
X Men The Last Stand (2006).BRRIP.frapper(HDScene.Release).br.srt	Aventura
Year One.DVDRip.ARROW.br.srt	Comédia
Yes Man.DVDScr.LTT.br.srt	Comédia
You Don t Mess With The Zohan.KingBen.br.srt	Comédia
Zabriskie Point(1970).br.srt	Drama
Zack and Miri Make a Porno.br.srt	Comédia Romântica
Zeitgeist The Movie.DVDRip.br.srt	Documentário
Zodiac.DVDRip.aXXo.br.srt	Crime
Zombieland.DVDRip.TxR.br.srt	Aventura
